1111111111111111111111111
1000000000000000000000001
1000000000000000000000001
1000000000000000000000001
1000000000000000011000001
1011000001000000100100001
1000000000100010000000001
1000011010001000000010101
1000000000000000000000001
1000000000000000000000001
1000000000100000000000001
1000000000000000000000001
1000000000000000000000001
1000001100000000000000001
1000000000000000000000001
1000000000000000000000001
1000000000000000000000001
1111111111111111111111111
