ÆÆÆÆÆÆÆÆÆÆÆÆÆÆÆÆÆÆÆÆÆÆÆÆÆ
ÆÆÆÆÆÆÆÆÆÆÆÆÆÆÆÆÆÆÆÆÆÆÆÆÆ
ÆÆÆÆÆÆÆÆÆÆÆÆÆÆÆÆÆÆÆÆÆÆÆÆÆ
ÆÆÆÆÆÆÆÆÆÆÆÆÆÆÆÆÆÆÆÆÆÆÆÆÆ
ÆÆÆÆÆÆÆÆÆÆÆÆÆÆÆÆÆÆÆÆÆÆÆÆÆ
ÆÆÆÆÆÆÆÆÆÆÆÆÆÆÆÆÆÆÆÆÆÆÆÆÆ
ÆÆÆÆÆÆÆÆÆÆÆÆÆÆÆÆÆÆÆÆÆÆÆÆÆ
ÆÆÆÆÆÆÆÆÆÆÆÆÆÆÆÆÆÆÆÆÆÆÆÆÆ
ÆÆÆÆÆÆÆÆÆÆÆÆÆÆÆÆÆÆÆÆÆÆÆÆÆ
ÆÆÆÆÆÆÆÆÆÆÆÆÆ{{ÆÆ{ÆÆÆÆÆÆÆ
ÆÆÆÆ{Æ{Æ{ÆÆÆÆÆÆÆÆÆÆ{ÆÆÆÆÆ
ÆÆ{ÆÆÆÆÆÆ{Æ{ÆÆÆÆÆÆÆÆÆÆÆÆÆ
ÆÆ{ÆÆ{{{{ÆÆÆÆ{ÆÆ{ÆÆÆÆÆÆÆÆ
ÆÆÆ{Æ{ÆÆÆ{ÆÆ{ÆÆÆÆ{Æ{!ÆÆÆÆ
ÆÆÆÆÆÆ!ÆÆÆÆÆÆ!ÆÆ{ÆÆ!Æ!ÆÆÆ
ÆÆÆÆÆÆÆÆ!!!ÆÆÆÆ!Æ!ÆÆÆÆÆÆÆ
ÆÆ!ÆÆÆÆÆÆÆÆÆÆÆÆÆÆÆÆÆÆÆÆÆÆ
ÆÆÆÆÆÆÆÆÆÆÆÆÆÆÆÆÆÆÆÆÆÆÆÆÆ
