",,,,,,,,,,,,,,,,,,,,,,,#
#-----------------------7
#-----------------------7
#-----------------------7
#-----------------------7
#-----------------------7
#-----------------------7
#-----------------------7
#-----------------------7
#-----------------------7
#-----------------------7
#-----------------------7
#-----------------------7
#-----------------------7
#-----------------------7
#-----------------------7
#-----------------------7
$.......................8
