1111111111111111111111111
1000001111010000010000011
1010101011010101011000001
1010101001010101011011101
1010101000000101011011101
1010101111111101011000001
1110001000000011011000001
1110101011110111011011101
0010101010000000001111101
1010100011111111111000001
1010101111110000100000101
1010100000111111110011101
1010101110111111110011101
1010101000111111111000101
1000101111111111110111101
1000100011111111110001101
1000111000000000011000001
1111111111111111111111111
