9CCCCCCCCCCCCCCCCCCCCCCCW
:ÆÆÆÆÆ"!"!Æ"ÆÆÆÆÆ"ÆÆÆÆÆ.X
:Æ"Æ"Æ"Æ""Æ"Æ"Æ"Æ"DÆÆÆÆÆX
:Æ"Æ"Æ"ÆÆ"Æ"Æ"Æ"Æ"DÆ666ÆX
:-"Æ"Æ"ÆÆ-ÆÆÆ"Æ"Æ"DÆ777ÆX
:Æ"Æ"Æ""""""""Æ"Æ"DÆÆÆÆÆX
:!"ÆÆÆ"ÆÆÆÆÆÆÆD"Æ"DÆÆÆÆÆX
:""Æ"Æ"Æ""""-"""Æ"DÆ666ÆX
(Æ"Æ"Æ"Æ"ÆÆÆÆÆÆÆÆ5D"777ÆX
:Æ"Æ"ÆÆÆ"""""""""""ÆÆÆÆÆX
:Æ"Æ"Æ"""OOOÆÆÆÆEÆÆÆÆÆ"ÆX
:Æ"Æ"ÆÆÆÆÆ""""""""ÆÆ666ÆX
:Æ"Æ"Æ"""Æ"!DDDDDDÆÆ777ÆX
:Æ"Æ"Æ"ÆÆÆ"""""""""ÆÆÆ"ÆX
:ÆÆÆ"-"""NNNNNNNNNÆ""!"ÆX
:ÆÆÆ"Æ5Æ""""""""""ÆÆÆ""ÆX
:ÆÆÆ"!"ÆÆÆÆÆÆ####!"ÆÆÆÆÆX
<FFFFFFFFFFFFFFFFFFFFFFFZ
