0000000000000000000000000
0000000000000000000000000
0000000000010010100000000
0000000000100000000000000
0000000001000000010000000
0000000000000100100000000
0000000000000000000000000
0000000010000000001000000
0000000000101000010000000
0000000000000000000000000
0000000000001100010100000
0000000000001111000000000
0000000100001111000000000
0000000000001000001000000
0000000000000000000000000
0000000000000000000000000
0000000000000000000000000
0000000000000000000000000
