0000000000000000000000000
0000000000000000000000000
00000000000,00,0,00000000
0000000000,00000000000000
000000000,0000000,0000000
0000000000000,00,00000000
0000000000000000000000000
00000000,000000000-000000
0000000000,0,0000+0000000
0000000000000000000000000
00000000000055000-0+00000
0000000000006666000000000
0000000+00007777000000000
000000000000+00000+000000
0000000000000000000000000
0000000000000000000000000
0000000000000000000000000
0000000000000000000000000
