0110000010000100010111111
0000001001000000000000001
0000000000000000000000001
0000000000000000000000001
0000000010000000000000001
0000000011000000000000001
0000000001000000000000001
0000000110000000010000001
0000000100010000000000001
0000000001000000000000001
0000000000000000000000001
0000000000000000000000001
0000000000000000000000001
0000000000000000000000001
0000000000000000000000001
0000000000000000000000011
0000000000000000000000001
1010100010010110110110111
