1111111111111111111111111
1000010100001111100000001
1000000000001111100000001
1000010100000000000000000
1000000000000000000000001
1101100001110000001100001
1010111011001100100000001
1011100101101000001001001
1000010110110000000010001
1000000000000110001100001
1000000000001001010000001
1000000000000000000000001
1000000000000001000010001
1000000000000000000000001
1000000000000000101000001
1000000000000000000000001
1000000000000000000000001
1111111111111111111111111
