1111111111111111111111111
1000000000000000000000001
1000000000000000000000001
1000000000000000000010001
1000001100000000000000001
1000001100000000000000001
1000000000001000000000001
1000000000000000000000001
1000000000000000111000001
1000000000001000111000001
1000000000001100000000001
1000000000000111000000001
1000000000000011100000001
1000000000000000000000001
1000000000000000000000001
1000000000000000000000001
1000000000000000000000001
1111111111111111111111111
