0111111111111111111111111
0111111111111111111111111
0111111111111111111111111
0111111111111111111111111
0000000000111111111111111
0000000000000000111111111
0000000000000000111111111
0000000000000000111111111
0000000000000000111111111
0000000000000000111111111
0000000000000000111111111
0000000000000000111111111
0000000000000000111111111
0000000000000000111111111
0000000000000000111111111
0000000000000000001111111
0000000000000000001111111
0000000000000000000000000
