1111111111111111111111111
1000000000000000000000011
1000000100000000000000001
1000000100111111111000001
1000000000111111111000001
1000000000000000000000001
1000000000111111111000011
1000000000111111111000011
1001111100000000000000011
1001111100111111111000000
1000011100111111111000011
1000000000000000000000011
1001111100000000000000001
1001111100000010000000001
1000000000000010000000001
1000000000000000000000001
1100000000000000000000011
1111111111110111111111111
