9CCCCCCCCCCCCCCCCCCCCCCCW
:ÆÆÆÆÆÆÆÆÆÆÆÆÆÆÆÆÆÆÆÆ#Æ!X
:ÆÆÆÆÆÆUÆÆÆÆÆÆÆÆÆÆÆÆÆ#ÆÆX
:ÆÆÆÆÆÆVÆÆ666666666ÆÆ###X
:ÆÆÆÆÆÆÆÆÆ777777777ÆÆÆÆÆX
:ÆÆÆÆÆÆÆÆÆÆÆÆÆÆÆÆÆÆÆÆÆÆÆX
:ÆÆÆÆÆÆÆÆÆ666666666ÆÆÆÆNX
:ÆÆÆÆÆÆÆÆÆ777777777ÆÆÆÆUX
:ÆÆ66666ÆÆÆÆÆÆÆÆÆÆÆÆÆÆÆVX
:ÆÆ77777ÆÆ666666666ÆÆÆÆÆ/
:ÆÆÆÆOOOÆÆ777777777ÆÆÆÆUX
:ÆÆÆÆÆÆÆÆÆÆÆÆÆÆÆÆÆÆÆÆÆÆVX
:ÆÆ66666ÆÆÆÆÆÆÆÆÆÆÆÆÆÆÆÆX
:ÆÆ77777ÆÆÆÆÆÆAÆÆÆÆÆÆÆÆÆX
:ÆÆÆÆÆÆÆÆÆÆÆÆÆBÆÆÆÆÆÆ---X
:ÆÆÆÆÆÆÆÆÆÆÆÆÆÆÆÆÆÆÆÆ-ÆÆX
:!ÆÆÆÆÆÆÆÆÆÆÆÆÆÆÆÆÆÆÆ-Æ!X
<FFFFFFFFFFF0FFFFFFFFFFFZ
