1111111111111111111111111
1000000000000000000000001
1000000000000010000000001
1000000000000000000000001
1000000000000000000000001
1000000000001100000000001
1000000000000000000000001
1000000000001000000000001
1000000000000000000000001
1000000000001000000000001
1000000000000010000000001
1000000000000000000000001
1000000000101000000000001
1000000000000000000000001
1000000001001100000000001
1000000000010000000000001
1000000000100000000000001
1111111111111111111111111
