1111111111011111111111111
1000000001000000010000001
1000000001111101001000001
1000000000000100101000001
1000000000000110101000000
1000000000000011100000001
1000000000000000011111111
1000000000000000000000001
1000000000000000000000001
1000000000000000000000001
1000000000000000000000001
1000000000000000000000001
1000000000000000000000001
1000000000000000000000001
1000000000000000000000001
1000000000000000000000001
1000000000000000000000001
1111111111111111111111111
