9CCCCCCCCC2CCCCCCCCCCCCCW
:ÆÆÆÆÆÆÆÆ"ÆÆÆÆÆÆÆ"ÆÆÆÆÆÆX
:ÆÆÆÆÆÆÆÆ"""""Æ"ÆÆ"ÆÆÆÆÆX
:ÆÆÆÆÆÆÆÆÆÆÆÆ"ÆÆ"Æ"ÆÆÆÆÆX
:ÆÆÆÆÆÆÆÆÆÆÆÆ""Æ"Æ"ÆÆÆÆÆ/
:ÆÆÆÆÆÆÆÆÆÆÆÆÆ"""ÆÆÆÆÆÆÆX
:ÆÆÆÆÆÆÆÆÆÆÆÆÆÆÆÆ"""""""X
:ÆÆÆÆÆÆÆÆÆÆÆÆÆÆÆÆÆÆÆÆÆÆÆX
:ÆÆÆÆÆÆÆÆÆÆÆÆÆÆÆÆÆÆÆÆÆÆÆX
:ÆÆÆÆÆÆÆÆÆÆÆÆÆÆÆÆÆÆÆÆÆÆÆX
:ÆÆÆÆÆÆÆÆÆÆÆÆÆÆÆÆÆÆÆÆÆÆÆX
:ÆÆÆÆÆÆÆÆÆÆÆÆÆÆÆÆÆÆÆÆÆÆÆX
:ÆÆÆÆÆÆÆÆÆÆÆÆÆÆÆÆÆÆÆÆÆÆÆX
:ÆÆÆÆÆÆÆÆÆÆÆÆÆÆÆÆÆÆÆÆÆÆÆX
:ÆÆÆÆÆÆÆÆÆÆÆÆÆÆÆÆÆÆÆÆÆÆÆX
:ÆÆÆÆÆÆÆÆÆÆÆÆÆÆÆÆÆÆÆÆÆÆÆX
:ÆÆÆÆÆÆÆÆÆÆÆÆÆÆÆÆÆÆÆÆÆÆÆX
<FFFFFFFFFFFFFFFFFFFFFFFZ
