1111111111111111111111111
1000000000000000000000001
1000000000000000000000001
1001000100000000100001001
1000000000000000000000001
1000000000000000000000001
1000000010000000000000101
1000000000000000000100001
1000000000000000000000001
1000001000010000000000001
1000000000000000000000001
1000000000000000000000001
1000000000000000000000001
1000000000000000000111101
1000000000000000000100101
1000000000000000000000001
1000000000000000000000001
1111111111111111111111111
