1111111111111111111111111
1000000000000000000000001
1000000000000000000000001
1000000000000000000111001
1000000000000000000000001
1000000000001111000000001
1000010000001111001100001
1000001000000000001100001
1000000100000000001100001
1000011000000000001100001
1000000100000000000000001
1000001000000000000000001
1000000000000000000000001
1000000000000000000011001
1000000000000000000000001
1000000000000000000000001
1000000000000000000000001
1111111111111011111111111
