9CCCCCCCCCCCCCCCCCCCCCCCW
:ÆÆÆÆÆÆÆÆÆÆÆÆÆÆÆÆÆÆÆÆÆÆÆX
:Æ+ÆÆÆÆÆÆÆÆÆÆÆÆÆÆÆÆÆÆÆÆÆX
:ÆÆÆÆÆÆÆÆÆÆÆÆÆÆÆÆÆÆ!!!ÆÆX
:ÆÆÆÆÆÆ###ÆÆÆÆÆÆÆÆÆÆÆÆÆÆX
:ÆÆÆÆÆÆÆ#Æ#Æ6666ÆÆÆÆÆÆÆÆX
:ÆÆÆÆ"ÆÆÆ#ÆÆ7777ÆÆ$$ÆÆÆÆX
:ÆÆÆÆÆ"ÆÆÆ#ÆÆÆÆÆÆÆ$$ÆÆÆÆX
:ÆÆÆÆÆÆ"ÆÆÆÆÆÆÆÆÆÆ$$ÆÆÆÆX
:ÆÆÆÆ""ÆÆÆÆÆÆÆÆ-ÆÆ$$ÆÆÆÆX
:ÆÆÆÆÆÆ"ÆÆÆÆ-ÆÆÆÆÆÆÆÆÆÆÆX
:ÆÆÆÆÆ"ÆÆÆÆÆÆÆ--ÆÆÆÆÆÆÆÆX
:ÆÆÆÆÆÆÆÆÆÆ-ÆÆ-ÆÆÆÆÆÆÆÆÆX
:ÆÆÆÆÆÆÆÆÆÆÆÆÆÆÆÆÆÆÆJ@ÆÆX
:ÆÆÆÆÆÆÆÆÆÆÆÆÆÆÆÆÆÆÆÆÆÆÆX
:ÆÆÆÆÆÆÆÆÆÆÆÆÆÆÆÆÆÆÆÆÆÆÆX
:ÆÆÆÆÆÆÆÆÆÆÆÆÆÆÆÆÆÆÆÆÆÆÆX
<FFFFFFFFFFFF0FFFFFFFFFFZ
