1111111111111111111111111
1000000000000000000000001
1000000000000000000000001
1000000000000000000000001
1000000000000000000000001
1000000000000001001000001
1000000000000000000000001
1000000000000100000000001
1000000000000000000000001
1000000000000010001000001
1000000000000000001000001
1000000000010000000000001
1000000000001000000000001
1000000000000000000000001
1000000000000000000000001
1000000000000000000000001
1000000000000000000000001
1111111111111111111111111
