1111111111111111111111111
1000000000000000000000001
1000000000000000000000001
1000000000000000000000001
1000000000000000000000001
1000000000000010000000001
1000000100000100001000001
0000000000000000000000000
1111110000000000000000001
1000000000000000000000001
1000000000000000000000001
1000100000000000000001001
1000000000001000000000001
1000000000000000000000001
1000000000000000000000001
1000000000000000000000001
1000000000000000000000001
1111111111011111111111111
