9CCCCCCCCCCCCCCCCCCCCCCCW
:ÆÆÆÆ!Æ!ÆÆÆÆ66666ÆÆÆÆÆÆÆX
:ÆÆÆÆÆÆÆÆÆÆÆ77777ÆÆÆÆÆÆÆX
:ÆÆÆÆ!Æ!ÆÆÆÆÆÆÆÆÆÆÆÆÆÆÆÆX
:ÆÆÆÆÆÆÆÆÆÆ5ÆÆÆÆÆÆÆÆÆÆÆÆX
:"Æ""ÆÆÆÆ"""ÆÆÆÆÆÆ$$ÆÆÆÆX
:Æ"Æ"""Æ""ÆÆ$$ÆÆ$ÆÆÆÆÆÆÆX
:Æ"""ÆÆ"Æ"$Æ$ÆÆÆÆÆ$ÆÆ$ÆÆX
:ÆÆÆÆ"Æ""Æ$$ÆÆÆÆÆÆÆÆ$ÆÆÆX
:ÆÆÆÆÆÆÆÆÆÆÆÆ$$ÆÆÆ$$ÆÆÆÆX
:ÆÆÆÆÆÆÆÆÆÆÆ$ÆÆ$Æ$ÆÆÆÆÆÆX
:ÆÆÆÆÆÆÆÆÆÆÆÆÆÆÆÆÆÆÆÆÆÆÆX
:ÆÆÆÆÆÆÆÆÆÆÆÆÆÆ$ÆÆÆÆ$ÆÆÆX
:ÆÆÆÆÆÆÆÆÆÆÆÆÆÆÆÆÆÆÆÆÆÆÆX
:ÆÆÆÆÆÆÆÆÆÆÆÆÆÆÆ$Æ$ÆÆÆÆÆX
:ÆÆÆÆÆÆÆÆÆÆÆÆÆÆÆÆÆÆÆÆÆÆÆX
:ÆÆÆÆÆÆÆÆÆÆÆÆÆÆÆÆÆÆÆÆÆÆÆX
<FFFFFFFFFFFFFFFFFFFFFFFZ
