1111111111111111111111111
1000000000000000000000011
1000000000000000000000001
1000000000001010000000001
1000000000001000000000001
1000000000000000000000001
1001111111000011110000001
1111001111110011110000001
1000000000010010000001111
1010100000000010000010000
1111001111000011110001111
1010011111110011110000011
1000010001011000000000001
1010100000000000000000001
1011011111000011110000001
1001011111000011110000001
1000010000000000000000011
1111111111101111111111111
