9CCCCCCCCCCCCCCCCCCCCCCCW
:ÆÆÆÆÆÆÆÆÆÆÆÆÆÆÆÆÆÆÆÆ#Æ!X
:ÆÆÆÆÆÆÆÆÆÆÆÆÆÆÆÆÆÆÆÆ#ÆÆX
:ÆÆÆÆÆÆÆÆÆÆÆDÆ"ÆÆÆÆÆÆ###X
:ÆÆÆÆÆÆÆÆÆÆÆDÆÆÆÆÆÆÆÆÆÆÆX
:ÆÆÆÆÆÆÆÆÆÆÆÆÆÆÆÆÆÆÆÆÆÆÆX
:ÆÆ"""6666ÆÆÆÆ6666ÆÆÆÆÆÆX
:"""ÆÆ7777""ÆÆ7777ÆÆÆÆÆÆ<
:ÆÆÆÆÆÆÆÆÆÆ"ÆÆDÆÆÆÆÆÆ9CMW
:Æ"Æ"ÆÆÆÆÆÆÆ5ÆDÆÆÆÆÆJ---&
:"""ÆÆ6666ÆÆÆÆ6666ÆÆÆ<PPZ
:Æ"ÆÆ"7777""ÆÆ7777ÆÆÆÆÆD9
:ÆÆÆÆ"ÆÆÆ"Æ""ÆÆÆÆÆÆÆÆÆÆÆ;
:Æ"Æ"ÆÆÆÆÆÆÆÆÆÆÆÆÆÆÆÆÆÆÆX
:Æ""Æ"6666ÆÆÆÆ6666ÆÆÆ---X
:ÆÆ"Æ"7777ÆÆÆÆ7777ÆÆÆ-ÆÆX
:ÆÆÆÆ"ÆÆÆÆÆÆÆÆÆÆÆÆÆÆÆ-Æ!X
<FFFFFFFFFF1FFFFFFFFFFFFZ
