1111111111111111111111111
1000000000000000000000001
1000000000100010000000001
1000000000000000000000001
1000000000000000000000001
1000000000000010000000001
1000111111100000000000001
1000111111100000000000001
1000000000000000000000001
1000000000000010000000001
1000000000000000000000001
1000000000000100000000001
1000000000000000000000001
1000000001000000000000001
1000000000000000000000001
1000000000000000000000001
1000000000000000000000001
1111111111101111111111111
