1111111111111111111111111
1000000000000000000000011
1010000000000000000000001
1000111111000111111000001
1000111111000111111000001
1000000000000000000000001
1001111111000111111000001
1111111111000111111001111
1100000000000000000001000
1000111111000111111001111
1000111111000111111000001
1010000010000000000000001
1011110000100000000000001
1111111010101010000000001
1110010100111100000000001
1010010100100010000000001
1000000000100000000000011
1111111111101111111111111
