0000000000000000000000000
0000001111111111111001100
0000001111111111111000000
0000000000000000000000110
0000001111111111111000110
0000001111111111111000000
0000000000000000000000110
0000001111111111111000110
0000001111111111111000000
0000000000000000000000000
0000001111111111111000000
0000001111111111111000000
0000000000000000000000000
0000001111111111111000000
0000001111111111111000000
0000001111111111000000000
0000001111111111111000000
0000000000000000000000000
