9CCCCCCCCCCCCCCCCCCCCCCCW
:55555555555555555555555X
:55555555555555555555555X
:55555555555555555555555X
:55555555555555555555555X
:55555555555555555555555X
:55555555555555555555555X
:55555555555555555555555X
:55555555555555555555555X
:55555555555555555555555X
:55555555555555555555555X
:55555555555555555555555X
:55555555555555555555555X
:55555555555555555555555X
:55555555555555555555555X
:55555555555555555555555X
:55555555555555555555555X
<FFFFFFFFFFFFFFFFFFFFFFFZ
