9CCCCCCCCCCCCCCCCCCCCCCCW
:ÆÆÆÆÆÆÆÆÆÆÆÆÆÆÆÆÆÆÆÆÆÆÆX
:Æ+ÆÆÆÆÆÆÆÆÆÆÆÆÆÆÆÆÆÆÆÆÆX
:ÆÆÆÆÆÆÆÆÆÆÆÆÆÆÆÆÆÆ!!!ÆÆX
:ÆÆÆÆÆÆÆÆÆÆÆÆÆÆÆÆÆÆÆÆÆÆÆX
:ÆÆÆÆÆÆÆÆÆÆÆ6666ÆÆÆÆÆÆÆÆX
:ÆÆÆÆ"ÆÆÆÆÆÆ7777ÆÆ$$ÆÆÆÆX
:ÆÆÆÆÆ"ÆÆÆÆÆÆÆÆÆÆÆ$$ÆÆÆÆX
:ÆÆÆÆÆÆ"ÆÆÆÆÆÆÆÆÆÆ$$ÆÆÆÆX
:ÆÆÆÆ""ÆÆÆÆÆÆÆÆÆÆÆ$$ÆÆÆÆX
:ÆÆÆÆÆÆ"ÆÆÆÆÆÆÆÆÆÆÆÆÆÆÆÆX
:ÆÆÆÆÆ"ÆÆÆÆÆÆÆÆÆÆÆÆÆÆÆÆÆX
:ÆÆÆÆÆÆÆÆÆÆÆÆÆÆÆÆÆÆÆÆÆÆÆX
:ÆÆÆÆÆÆÆÆÆÆÆÆÆÆÆÆÆÆÆÆÆÆÆX
:ÆÆÆÆÆÆÆÆÆÆÆÆÆÆÆÆÆÆÆÆÆÆÆX
:ÆÆÆÆÆÆÆÆÆÆÆÆÆÆÆÆÆÆÆÆÆÆÆX
:ÆÆÆÆÆÆÆÆÆÆÆÆÆÆÆÆÆÆÆÆÆÆÆX
<FFFFFFFFFFFF0FFFFFFFFFFZ
