0000000000000000000000000
000000666666666666600++00
0000007777777777777000000
0000000000000000000000!!0
0000006666666666666000!!0
00000077777777777770000"0
0000000000000000000000!!0
0000006666666666666000!!0
0000007777777777777000000
0000008000000000000000000
0000006666666666666000000
0000007777777777777000000
0000000000000000000000000
0000006666666666666000000
0000007777777777777000000
0000000000000000000000000
000000$$$$$$$$$$$$$000000
0000000000000000000000000
