9CCCCCCCCCCCCCCCCCCCCCCCW
:ÆÆÆÆÆÆÆÆÆÆÆÆÆÆÆÆÆÆÆÆ#Æ!X
:Æ.ÆÆÆÆÆÆÆÆÆÆÆÆÆÆÆÆÆÆ#ÆÆX
:ÆÆÆ666666ÆÆÆ666666ÆÆ###X
:ÆÆÆ777777ÆÆÆ777777ÆÆÆÆÆX
:ÆÆÆÆÆÆÆÆÆÆÆÆÆÆÆÆÆÆÆÆÆÆÆX
:ÆÆ"666666ÆÆÆ666666ÆÆÆÆÆX
:!""777777ÆÆÆ777777ÆÆD9FX
:"ÆÆÆÆÆÆÆÆÆÆÆÆÆÆÆÆÆÆÆJ+-/
:ÆÆÆ666666ÆÆÆ666666ÆÆD<CX
:ÆÆÆ777777ÆÆÆ777777ÆÆÆÆÆX
:Æ"ÆÆÆÆÆ"ÆÆÆÆÆÆÆÆÆÆÆÆÆÆÆX
:Æ""""ÆÆÆÆ"ÆÆÆÆÆÆÆÆÆÆÆÆÆX
:""!!""Æ"Æ"Æ"Æ"ÆÆÆÆÆÆÆÆÆX
:!"ÆÆ"Æ"ÆÆ""E"ÆÆÆÆÆÆÆ---X
:Æ"ÆÆ"Æ"ÆÆ"ÆÆÆ"ÆÆÆÆÆÆ-ÆÆX
:ÆÆÆÆÆÆÆÆÆ"ÆÆÆÆÆÆÆÆÆÆ-Æ!X
<FFFFFFFFFF1FFFFFFFFFFFFZ
