9CCCCCCCCCCCCCCCCCCCCCCCW
:ÆÆÆÆÆÆÆÆÆÆÆÆÆÆÆÆÆÆÆÆÆÆÆX
:ÆÆÆÆÆÆÆÆÆ$ÆÆÆ$ÆÆÆÆÆÆÆÆÆX
:ÆÆÆÆÆÆÆÆÆÆÆÆÆÆÆÆÆ####ÆÆX
:ÆÆÆÆÆÆÆÆÆÆÆÆÆÆÆÆÆ#ÆÆ#ÆÆX
:ÆÆÆÆÆÆÆÆÆÆÆÆÆ$ÆÆÆ#ÆÆ#ÆÆX
:ÆÆÆ6666666ÆÆÆÆÆÆÆ#ÆÆ#ÆÆX
:ÆÆÆ7777777ÆÆÆÆÆÆÆ#ÆÆ#ÆÆX
:ÆÆÆÆÆÆÆÆÆÆÆÆÆÆÆÆÆ#ÆÆ#ÆÆX
:ÆÆÆÆÆÆÆÆÆÆÆÆÆ$ÆÆÆ#ÆÆ#ÆÆX
:ÆÆÆÆÆÆÆÆÆÆÆÆÆÆÆÆÆ####ÆÆX
:ÆÆÆÆÆÆÆÆÆÆÆÆ$ÆÆÆÆÆÆÆÆÆÆX
:ÆÆÆÆÆÆÆÆÆÆÆÆÆÆÆÆÆÆÆÆÆÆÆX
:ÆÆÆÆÆÆÆÆ$ÆÆÆÆÆÆÆÆÆÆÆÆÆÆX
:ÆÆÆÆÆÆÆÆÆÆÆÆÆÆÆÆÆÆÆÆÆÆÆX
:ÆÆÆÆÆÆÆÆÆÆÆÆÆÆÆÆÆÆÆÆÆÆÆX
:ÆÆÆÆÆÆÆÆÆÆÆÆÆÆÆÆÆÆÆÆÆÆÆX
<FFFFFFFFFF0FFFFFFFFFFFFZ
