1111111111111111111111111
1000000000000000000000001
1000000000000000000000001
1000000000000000000000001
1000000000000000010000001
1000000000100010000000001
1000000000000000000000001
1000001000000000000000001
1000000000000000000000000
1000001000000000100000001
1000000000010011000000001
1000000000000000000000001
1000000000000000000000001
1000000000000000000000001
1000000000000000000000001
1000000000000000000000001
1000000000000000000000001
1111111111101111111111111
