1111111111111111111111111
1000000000000000000010001
1010000000000000000000001
1000100001000000010000001
1000000000001000000010001
1000000100000000000000001
1000000000000010000001001
1100100000000000000000001
1000000000000000000010001
1000000000000000010000001
1000001000000000000000001
1000000000000010000000101
1000010000000000001000001
1001000010000001000000001
1000000000000000000000001
1000000000100000000001001
1000000000000000000000001
1111111111111111111111111
