9CCCCCCCCCCCCCCCCCCCCCCCW
:ÆÆÆÆÆÆÆÆÆÆÆÆÆÆÆÆÆÆÆÆÆÆÆX
:ÆÆÆÆÆÆÆÆÆÆÆÆÆÆÆÆÆÆÆÆÆÆÆX
:ÆÆÆÆÆÆÆÆÆÆÆÆÆÆÆÆÆÆÆÆÆÆÆX
:ÆÆÆ##ÆÆÆÆ########Æ##ÆÆÆX
:ÆÆÆ##ÆÆÆÆ###ÆÆ###Æ##ÆÆÆX
:ÆÆÆ##ÆÆÆÆ###ÆÆ###Æ##ÆÆÆX
:ÆÆÆ##ÆÆÆÆ###ÆÆ###Æ##ÆÆÆX
:ÆÆÆ##ÆÆÆÆ###ÆÆ###Æ##ÆÆÆX
:ÆÆÆ##ÆÆÆÆ###ÆÆ###Æ##ÆÆÆX
:ÆÆÆ##ÆÆÆÆ###ÆÆ###Æ##ÆÆÆX
:ÆÆÆ##ÆÆÆÆ###ÆÆ###Æ##ÆÆÆX
:ÆÆÆ#####Æ###ÆÆ###Æ#####X
:ÆÆÆ#####Æ########Æ#####X
:ÆÆÆÆÆÆÆÆÆÆÆÆÆÆÆÆÆÆÆÆÆÆÆX
:ÆÆÆÆÆÆÆÆÆÆÆÆÆÆÆÆÆÆÆÆÆÆÆX
:ÆÆÆÆÆÆÆÆÆÆÆÆÆÆÆÆÆÆÆÆÆÆÆX
<FFFFFFFFFFFF0FFFFFFFFFFZ
