1111111111111111111111111
1000000000000000000000001
1000000000000000000000001
1000000000000000000000001
1000000000000000000000001
1000000000000000000000001
1000000010000000000000001
1000000000000000000000001
0000000000010000000000001
1000100000000000000000001
1000000000000000010000001
1000000001000000000000001
1000000000000100000000001
1000000000000000000000001
1000000000000000000000001
1000000000000000000000001
1000000000000000000000001
1111111111111111111111111
