9CCCCCCCCCCCCCCCCCCCCCCCW
:ÆÆÆÆÆÆÆÆÆÆÆÆÆÆÆÆÆÆÆÆÆÆÆX
:ÆÆÆÆÆÆÆÆÆÆÆÆÆÆÆÆÆÆÆÆÆÆÆX
:ÆÆÆÆÆÆÆÆÆÆÆÆÆÆÆÆÆÆÆÆÆÆÆX
:ÆÆÆÆÆÆÆÆÆÆÆÆÆÆÆÆÆÆÆÆÆÆÆX
:ÆÆÆÆÆÆÆÆÆÆÆÆÆÆÆÆÆÆÆÆÆÆÆX
:ÆÆÆÆÆÆÆ"ÆÆÆÆÆÆÆÆÆÆÆÆÆÆÆX
:ÆÆÆÆÆÆÆÆÆÆÆÆÆÆÆÆÆÆÆÆÆÆÆX
%ÆÆÆÆÆÆÆÆÆÆ"ÆÆÆÆÆÆÆÆÆÆÆÆX
:ÆÆÆ"ÆÆÆÆÆÆÆÆÆÆÆÆÆÆÆÆÆÆÆX
:ÆÆÆÆÆÆÆÆÆÆÆÆÆÆÆÆ"ÆÆÆÆÆÆX
:ÆÆÆÆÆÆÆÆ"ÆÆÆÆÆÆÆÆÆÆÆÆÆÆX
:ÆÆÆÆÆÆÆÆÆÆÆÆ"ÆÆÆÆÆÆÆÆÆÆX
:ÆÆÆÆÆÆÆÆÆÆÆÆÆÆÆÆÆÆÆÆÆÆÆX
:ÆÆÆÆÆÆÆÆÆÆÆÆÆÆÆÆÆÆÆÆÆÆÆX
:ÆÆÆÆÆÆÆÆÆÆÆÆÆÆÆÆÆÆÆÆÆÆÆX
:ÆÆÆÆÆÆÆÆÆÆÆÆÆÆÆÆÆÆÆÆÆÆÆX
<FFFFFFFFFFFFFFFFFFFFFFFZ
