1111111111111111111111111
1000000000001000000000001
1000000000001000000000001
1000000000001000000000001
1000000000001000000000001
1000001000000100000000001
1000000000000100000000001
1000000000001000000000001
1000000000000100000000001
1010000000001000000000001
1000000000001000000000001
1000000000001000000000001
1000000000001000000000001
1000000000001000000000001
1000000000001000000000001
1000000000000000000000001
1000000000001000000000001
1111111111111111111111111
