1111111111111111111111111
1000000001000000000000001
1010000000000000000000001
1000000000100000000000001
1000000000010000000000001
1000000000000000000000001
1000000010000000000000011
1000000000010000000000011
1000000000000000000000001
1000000000100000000000001
1000000001000000000000001
1000000000000000000000001
1000000010000000000000001
1000000000000000000000001
1000000001000000000000001
1000000101000000000000001
1000000000000000000000001
1111111111111111111111111
