1111111111111111111111111
1000000000000000000000001
1000000100000000000000001
1000000010000000000000001
1000000000001001000000001
1000000001000000000000001
1000000000000000001000001
1000000000010000000000001
1000000000000000000000001
1000000000000100000000001
1000000000000001000000001
1000000000000000000000001
1000000000000000100000001
1000000000000000011000001
1000000000000000000010001
1000000000000000000000001
1000000000000000000001001
1111111111111111111111111
