9CCCCCCCCCCCCCCCCCCCCCCCW
:ÆÆÆÆÆÆÆÆÆÆÆÆÆÆÆÆÆÆÆÆÆÆÆX
:ÆÆÆÆÆÆÆÆÆÆÆÆÆÆÆÆÆÆÆÆÆÆÆX
:ÆÆÆÆÆÆÆÆÆÆÆÆÆÆÆÆÆÆÆÆÆÆÆX
:ÆÆÆÆÆÆÆÆÆÆÆ##ÆÆÆÆÆÆÆÆÆÆX
:ÆÆÆÆÆÆÆ#ÆÆÆÆÆÆ#ÆÆÆÆÆÆÆÆX
:ÆÆÆÆÆÆÆÆÆÆÆÆÆÆÆÆÆÆÆÆÆÆÆX
:ÆÆÆÆÆÆ#ÆÆÆÆÆÆÆÆ#ÆÆÆÆÆÆÆX
:ÆÆÆÆÆÆ#ÆÆÆÆÆÆÆÆÆÆÆÆÆÆÆÆX
:ÆÆÆÆÆÆÆÆÆÆÆÆÆÆÆ#ÆÆÆÆÆÆÆ&
:ÆÆÆÆÆÆÆ##ÆÆÆÆÆÆÆ#ÆÆÆÆÆÆX
:ÆÆÆÆÆÆÆÆÆÆÆÆÆ#ÆÆÆÆÆÆÆÆÆX
:ÆÆÆÆÆ#ÆÆÆÆÆÆÆÆÆÆÆÆÆÆÆÆÆX
:ÆÆÆÆÆÆÆÆÆÆÆÆÆ#Æ#ÆÆÆÆÆÆÆX
:ÆÆÆÆÆÆÆÆÆÆÆ#ÆÆÆÆÆÆÆÆÆÆÆX
:ÆÆÆÆÆÆÆÆÆÆÆÆÆÆÆÆÆÆÆÆÆÆÆX
:ÆÆÆÆÆÆÆÆÆÆÆÆÆÆÆÆÆÆÆÆÆÆÆX
<FFFFFFFFFF0FFFFFFFFFFFFZ
