9CCCCCCCCCCCCCCCCCCCCCCCW
:ÆÆÆÆÆÆÆÆÆÆÆ"ÆÆÆÆÆÆÆÆÆÆÆX
:ÆÆÆÆÆÆÆÆÆÆÆ"ÆÆÆÆÆÆÆÆÆÆÆX
:ÆÆÆÆÆÆÆÆÆÆÆ"ÆÆÆÆÆÆÆÆÆÆÆX
:ÆÆÆÆÆÆÆÆÆÆÆ"ÆÆÆÆÆÆÆÆÆÆÆX
:ÆÆÆÆÆ!ÆÆÆÆÆÆ"ÆÆÆÆÆÆÆÆÆÆX
:ÆÆÆÆÆÆÆÆÆÆÆÆ"ÆÆÆÆÆÆÆÆÆÆX
:ÆÆÆÆÆÆÆÆÆÆÆ"ÆÆÆÆÆÆÆÆÆÆÆX
:ÆÆÆÆÆÆÆÆÆÆÆÆ"ÆÆÆÆÆÆÆÆÆÆX
:Æ!ÆÆÆÆÆÆÆÆÆ"ÆÆÆÆÆÆÆÆÆÆÆX
:ÆÆÆÆÆÆÆÆÆÆÆ"ÆÆÆÆÆÆÆÆÆÆÆX
:ÆÆÆÆÆÆÆÆÆÆÆ"ÆÆÆÆÆÆÆÆÆÆÆX
:ÆÆÆÆÆÆÆÆÆÆÆ"ÆÆÆÆÆÆÆÆÆÆÆX
:ÆÆÆÆÆÆÆÆÆÆÆ"ÆÆÆÆÆÆÆÆÆÆÆX
:ÆÆÆÆÆÆÆÆÆÆÆ"ÆÆÆÆÆÆÆÆÆÆÆX
:ÆÆÆÆÆÆÆÆÆÆÆÆÆÆÆÆÆÆÆÆÆÆÆX
:ÆÆÆÆÆÆÆÆÆÆÆ"ÆÆÆÆÆÆÆÆÆÆÆX
<FFFFFFFFFFFFFFFFFFFFFFFZ
