ÆÆÆÆÆÆÆÆÆÆÆÆÆÆÆÆÆÆÆÆÆÆÆÆÆ
ÆÆÆÆÆÆÆÆÆÆSÆÆÆÆÆÆÆÆÆÆÆÆÆÆ
ÆÆÆÆÆÆSÆÆÆÆÆÆÆÆÆÆÆÆÆÆÆÆÆÆ
ÆÆÆÆÆSÆÆÆÆÆÆÆÆÆÆÆÆÆÆÆSÆÆÆ
ÆÆÆÆÆÆSÆÆÆÆÆSÆÆÆÆSÆÆÆSÆÆÆ
ÆÆÆSÆÆÆÆÆÆÆSÆÆÆSÆÆÆÆÆÆÆÆÆ
ÆSÆSÆÆÆÆÆÆSÆÆÆÆÆÆÆÆÆSSÆÆÆ
ÆÆÆÆÆÆÆÆÆÆÆÆÆÆÆÆÆÆÆÆÆÆÆÆÆ
ÆÆÆÆÆÆSÆÆÆÆÆÆÆÆÆÆSÆÆÆÆÆÆÆ
ÆÆÆÆSÆÆÆÆÆÆÆÆÆÆÆÆÆSSÆÆÆÆÆ
ÆÆÆÆÆÆÆSÆÆÆÆÆÆÆÆÆÆÆÆSÆÆSÆ
ÆÆÆÆSÆÆÆSÆÆÆÆÆÆÆÆÆÆÆÆÆÆÆÆ
ÆÆÆÆÆÆÆÆÆÆÆÆSÆÆÆÆÆÆÆÆÆÆÆÆ
ÆÆÆÆSÆÆSÆÆÆÆÆÆÆÆÆÆÆÆSÆÆÆÆ
ÆÆÆÆÆÆSSÆÆÆÆÆÆÆÆÆÆÆSSÆÆÆÆ
ÆÆÆÆÆÆÆÆÆÆÆÆSÆSÆSÆÆÆÆÆÆÆÆ
ÆÆÆÆÆÆÆÆÆÆÆÆÆÆÆÆÆÆÆÆÆÆÆÆÆ
ÆÆÆÆÆÆÆÆÆÆÆÆÆÆÆÆÆÆÆÆÆÆÆÆÆ
