1111111111111111111111111
1000000000000000000000001
1000000000000000000000001
1000000000000000000000001
1000000100000110000000001
1000000000000000000000001
1000000000000000001000001
1000010000100000000000001
1000000000001000000000001
1000010001000010000100001
1000000000000000000000001
1000000000000000000001001
1010000010000000100001001
1000000000000000000000001
1000000000001000000000001
1000000000000000000000001
1000000000000000000000001
1111111111111111111111111
