1111111111111111111111111
1100000000000000000000001
1010100000000000001000001
1000110010100000000110001
1000000000001101000000001
1010111010000000000001001
1000100011010111110100101
1010010000000000001001001
1010010001110000000000001
1001000100001010100100001
1000000000001110000001001
1000100001100000000101001
1000010000000000000000001
1000000000000010100100001
1101000101010010010000101
1000010000000010101001101
1000000000000000000000001
1111111111111111111111111
