9CCCCCCCCCCCCCCCCCCCCCCCW
:"ÆÆÆÆÆÆÆÆÆÆÆÆÆÆÆÆÆÆÆÆÆÆX
:Æ"Æ"ÆÆÆÆÆÆÆÆÆÆÆÆÆ"ÆÆÆÆÆX
:ÆÆÆ""ÆÆ"Æ"ÆÆÆÆÆÆÆÆ""ÆÆÆX
:ÆÆÆÆÆÆÆÆÆÆÆ""Æ"ÆÆÆÆÆÆÆÆX
:Æ"Æ"""Æ"ÆÆÆÆÆÆÆÆÆÆÆÆ"ÆÆX
:ÆÆÆ"ÆÆÆ""Æ"Æ"""""Æ"ÆÆ"ÆX
:Æ"ÆÆ"ÆÆÆÆÆÆÆÆÆÆÆÆ"ÆÆ"ÆÆX
:Æ"ÆÆ"ÆÆÆ"""ÆÆÆÆÆÆÆÆÆÆÆÆX
:ÆÆ"ÆÆÆ"ÆÆÆÆ"Æ"Æ"ÆÆ"ÆÆÆÆX
:ÆÆÆÆÆÆÆÆÆÆÆ"""ÆÆÆÆÆÆ"ÆÆX
;ÆÆÆ"ÆÆÆÆ""ÆÆÆÆÆÆÆÆ"Æ"ÆÆX
:ÆÆÆÆ"ÆÆÆÆÆÆÆÆÆÆÆÆÆÆÆÆÆÆX
:ÆÆÆÆÆÆÆÆÆÆÆÆÆ"Æ"ÆÆ"ÆÆÆÆX
:"Æ"ÆÆÆ"Æ"Æ"ÆÆ"ÆÆ"ÆÆÆÆ"ÆX
:ÆÆÆÆ"ÆÆÆÆÆÆÆÆ"Æ"Æ"ÆÆ""ÆX
:ÆÆÆÆÆÆÆÆÆÆÆÆÆÆÆÆÆÆÆÆÆÆÆX
<FFFFFFFFFFFFFFFFFFFFFFFZ
