0000000000000000000000000
0000000100000000001010000
0001000010000010001010000
0000000001000100100001000
0001000010010000010100000
0000101101000000001000000
0000000011000110110000000
0000000100001001000010000
0000001000100001001000000
0000100010000000100000000
0000010101100010100000000
0000000000001100001000000
0000001010000000000010000
0000000010110011000000000
0000010000100100010000000
0000000000000001000000000
0000000000000000000000000
0000000000000000000000000
