0000010000010000000000000
0000010000010000000000000
0000010010010000000000000
0000011110010000000000000
0000000000010000000000000
0000000000010000000000000
0000000000010000000000000
0000000000010000000000000
1111111111110000000000000
0000000000000000000000000
0000000000000000000000000
0000000000000000000000000
0000000000000000000000000
0000000000000000000000000
0000000000000000000000000
0000000000000000000000000
0000000000000000000000000
0000000000000000000000000
