1111111111111111111111111
1000000000010000000000011
1000000000010000000000011
1000000000010000000000011
1000000000010000000000011
1000000000010000100000011
1000000000011111100000011
1000000000000000000000011
1000000000000000000000011
1000000000000000000000011
1000000000000000000000011
1000000000000000000000011
1000000000000000000000011
1000000000000000000000011
1000000000000000000000011
1000000000000000000000011
1111111111111111111111111
1111111111111111111111111
