9CCCCCCCCCCCCCCCCCCCCCCCW
:ÆÆÆÆÆÆÆÆÆÆ!ÆÆÆÆÆÆÆÆÆÆÆ!X
:ÆÆÆÆÆÆÆÆÆÆ!ÆÆÆÆÆÆÆÆÆÆÆ!X
:ÆÆÆÆÆÆÆÆÆÆ!ÆÆÆÆÆÆÆÆÆÆÆ!X
:ÆÆÆÆÆÆÆÆÆÆ!ÆÆÆÆÆÆÆÆÆÆÆ!X
:ÆÆÆÆÆÆÆÆÆÆ!ÆÆÆÆ!ÆÆÆÆÆÆ!X
:ÆÆÆÆÆÆÆÆÆÆ!!!!!!ÆÆÆÆÆÆ!X
:ÆÆÆÆÆÆÆÆÆÆÆÆÆÆÆÆÆÆÆÆÆÆ!X
:ÆÆÆÆÆÆÆÆÆÆÆÆÆÆÆÆÆÆÆÆÆÆ!X
:ÆÆÆÆÆÆÆÆÆÆÆÆÆÆÆÆÆÆÆÆÆÆ!X
:ÆÆÆÆÆÆÆÆÆÆÆÆÆÆÆÆÆÆÆÆÆÆ!X
:ÆÆÆÆÆÆÆÆÆÆÆÆÆÆÆÆÆÆÆÆÆÆ!X
:ÆÆÆÆÆÆÆÆÆÆÆÆÆÆÆÆÆÆÆÆÆÆ!X
:ÆÆÆÆÆÆÆÆÆÆÆÆÆÆÆÆÆÆÆÆÆÆ!X
:ÆÆÆÆÆÆÆÆÆÆÆÆÆÆÆÆÆÆÆÆÆÆ!X
:ÆÆÆÆÆÆÆÆÆÆÆÆÆÆÆÆÆÆÆÆÆÆ!X
:!!!!!!!!!!!!!!!!!!!!!!!X
<FFFFFFFFFFFFFFFFFFFFFFFZ
